11111111
10000000
1E0P0000
10000000
10C00000
11111111
