111111111111111111111111
1C001001C001000000001011
101100010000110010110001
100001000000000C00011001
1001CE011000P01100C00001
111111111111111111111111
