111111111111111111111111
1C001001C001100000001011
101100010000110010110001
100001000100000C00011001
1001CE011000P011100C0011
111111111111111111111111
