1111111111111111111111111
1P0E000C00000000C000000C1
1010010111101001010000101
1010100100001001011001101
10110001110C1001010110101
1C11000111001001010000101
1010100100001001010000101
1C1001C111101111C1000C101
1000000000000000000000001
1111111111111111111111111
