111111111111111111111111
1P1E000C0110000111001111
101101100001000000000111
100010001100011111000011
111010100011110000010111
1C00001C10000000110100C1
111111111111111111111111
