11111
1P001
10C01
1E001
11111
