1111111111
1000000001
1000000001
10000001
1000000001
1000000001
1111111111
