1111111
10000001
1E0P0001
10000001
10C00001
11111111
