1111111111
101E000C01
1000C01001
111000P001
1100101111
10C01000C1
1111111111
