11111
10CP1
10E01
11111 













































