11111
1P001
10E01
10001
11111
